"a" = (/turf/wall,/area)
"b" = (/turf/floor,/area)
"c" = (/turf/start,/area)

(1,1,1) = {"
aaaaaaaaaa
abbbbbbaba
abbbbbbaba
abbaaababa
abbacbbaba
abbaaaaaba
abbbbbbbba
abbbbbbbba
abbbbbbbba
aaaaaaaaaa
"}
